11111111111111111111
10000000000000000001
10011111111111111111
10000000000000010001
11111111111110010001
10000000000010010001
10001111110010010011
10001000010010010011
10001000000010000011
10001111111110000111
10000000000000010001
10101010101010101001
10000000000000000001
10101010101010101001
10000000000000000001
10000000000000000001
10001111111111110001
10000000000000110001
11111111111111111111
