11111111111111111111
10000000000000000001
10000000000000000001
10000000000000000001
10000000000000000001
10000000000000000001
11111110001111111111
11111100000011111111
10000000000000000001
10000001000010000001
10000000000000000001
10000001000010000001
10000001111110000001
10000001000000000001
10001111000011110001
10001000000010000001
11111001010011111111
10000001010000000001
11111111111111111111
